1,1-1,1-1,1-1,1-1,1-1,1-1,1-1,1-1,1-1,1-1,1-1,1-1,1-1,1-1,1-1,1-1,1-1,1-1,1-1,1-1,1-1,2-1,6-1,2-1,1
1,1-1,1-1,1-1,3-1,3-1,1-1,1-1,1-1,1-1,3-1,3-1,1-1,0-1,0-1,0-1,0-1,0-1,1-1,1-1,0-1,0-1,0-1,5-1,1-1,1
1,1-1,1-1,1-1,3-1,3-1,3-1,0-1,3-1,3-1,3-1,3-1,3-1,0-1,10-1,10-1,10-1,0-1,1-1,0-1,0-1,0-1,0-1,5-1,0-1,1
1,1-1,1-1,3-1,3-1,3-1,0-1,0-1,0-1,3-1,2-1,0-1,0-1,7-1,0-1,5-1,0-1,7-1,0-1,0-1,0-1,0-1,5-1,5-1,0-1,1
1,1-1,3-1,3-1,3-1,0-1,0-1,0-1,0-1,0-1,0-1,0-1,0-1,0-1,0-1,5-1,0-1,0-1,0-1,0-1,0-1,5-1,5-1,0-1,1-1,1
1,1-1,3-1,3-1,3-1,0-1,0-1,10-1,0-1,0-1,0-1,5-1,5-1,5-1,5-1,5-1,5-1,5-1,5-1,5-1,5-1,5-1,0-1,0-1,0-1,1
1,1-1,3-1,3-1,0-1,0-1,0-1,5-1,0-1,7-1,0-1,5-1,0-1,0-1,0-1,0-1,0-1,0-1,0-1,5-1,7-1,0-1,0-1,0-1,1-1,1
1,1-1,3-1,0-1,0-1,0-1,0-1,5-1,5-1,5-1,5-1,5-1,0-1,8-1,8-1,8-1,8-1,8-1,0-1,5-1,0-1,0-1,0-1,0-1,1-1,1
1,1-1,1-1,0-1,0-1,0-1,0-1,0-1,0-1,0-1,0-1,5-1,0-1,8-1,8-1,8-1,8-1,8-1,0-1,5-1,0-1,0-1,0-1,1-1,1-1,1
1,1-1,0-1,0-1,0-1,10-1,0-1,1-1,0-1,0-1,0-1,5-1,0-1,8-1,8-1,8-1,8-1,8-1,0-1,5-1,0-1,0-1,2-1,2-1,1-1,1
1,1-1,0-1,0-1,0-1,5-1,5-1,5-1,5-1,5-1,7-1,5-1,0-1,0-1,0-1,0-1,0-1,0-1,0-1,5-1,0-1,0-1,2-1,1-1,1-1,1
1,1-1,0-1,0-1,0-1,1-1,1-1,0-1,0-1,5-1,5-1,5-1,5-1,5-1,5-1,5-1,5-1,5-1,5-1,5-1,0-1,3-1,3-1,3-1,1-1,1
1,1-1,1-1,0-1,0-1,1-1,1-1,0-1,0-1,0-1,5-1,0-1,0-1,0-1,0-1,0-1,0-1,0-1,0-1,5-1,7-1,2-1,3-1,3-1,1-1,1
1,1-1,1-1,0-1,0-1,0-1,0-1,10-1,0-1,0-1,5-1,0-1,0-1,0-1,0-1,0-1,0-1,0-1,0-1,5-1,5-1,2-1,3-1,3-1,3-1,1
1,1-1,1-1,0-1,0-1,0-1,0-1,5-1,5-1,5-1,5-1,7-1,0-1,10-1,0-1,1-1,0-1,0-1,0-1,0-1,5-1,5-1,3-1,3-1,1-1,1
1,1-1,1-1,1-1,1-1,0-1,0-1,0-1,0-1,0-1,5-1,5-1,5-1,5-1,0-1,0-1,0-1,0-1,0-1,0-1,0-1,5-1,5-1,5-1,6-1,1
1,1-1,1-1,3-1,1-1,0-1,0-1,0-1,0-1,0-1,0-1,1-1,1-1,1-1,0-1,1-1,0-1,0-1,0-1,0-1,0-1,0-1,0-1,0-1,1-1,1
1,1-1,1-1,1-1,1-1,1-1,1-1,1-1,1-1,1-1,1-1,1-1,1-1,1-1,1-1,1-1,1-1,1-1,1-1,1-1,1-1,1-1,1-1,1-1,1-1,1
