1,11-1,11-1,11-1,11-1,11-1,11-1,11-1,11
1,11-2,0-2,0-2,0-2,0-2,0-2,0-1,11
1,11-2,0-2,0-2,0-2,0-2,0-2,0-1,11
1,11-2,0-2,0-2,0-2,0-2,0-2,0-1,11
1,11-2,0-2,0-2,0-2,0-2,0-2,0-1,11
1,11-2,0-2,0-2,0-2,0-2,0-2,0-1,11
1,11-2,0-2,0-2,0-2,0-2,0-2,0-1,11
1,11-1,11-1,11-1,11-1,6-1,11-1,11-1,11
